W W W W W W W W W W W W W W W W W W W W W W W W W W W W W W W W W W W W W W W W W W W W W W W W W W 
W . . . . . . . . . . . . . . . . . . . . . . . . . . . . . . . . . . . . . . . . . . . . . . . . W 
W . 5 5 5 5 5 5 5 5 5 5 5 5 5 5 5 5 5 5 5 5 5 5 5 5 5 5 5 5 5 5 5 5 5 5 5 5 5 5 5 5 5 5 5 5 . . . W 
W . 5 . . . . . . . . . . . . . . . . . . . . . . . . . . . . . . . . . . . . . . . . . 5 5 . . . W 
W . 5 . . . . . . . . . . . . . . . . . . . . . . . . . . . . . . . . . . . . . . . . . . 5 . . . W 
W . 5 . . . . . . . . . . . . . . . . . . . . . . . . . . . . . . . . . . . . . . . . . . 5 . . . W 
W . 5 5 . . . . . . . . . . 5 5 5 5 . . . . . . . . . . . . . . . . . . . . . . . . . . . 5 . . . W 
W . 5 5 5 . . . . . . . . . . 5 5 5 . . . . . . . . . . . . . . . . . . . . . . . . . . . 5 . . . W 
W . 5 5 5 . . . . . . . . . . . 5 . . . . . . 5 5 5 5 5 5 5 5 5 5 5 5 5 5 5 . . . . . . . 5 . . . W 
W . 5 5 5 . . . . . . . . . . . . . . . . . . 5 . . . . . . . . . . . . . 5 . . . . . . . 5 . . . W 
W . 5 5 5 . . . . . . . . . . . . . . . . . . 5 . . . . . . . . . . . . . 5 . . . . . . . 5 . . . W 
W . 5 5 5 . . . . . . . . . . . . . . . . . . 5 . . . . . . . . . . . . . 5 . . . . . . . 5 . . . W 
W . 5 5 5 . . . . . . . . . . . . . . . . . . 5 5 5 5 . . . . . . . . . . 5 . . . . . . . 5 . . . W 
W . 5 5 5 . . . 5 5 . . . . . . . . . . . . . . . . . . . . . . . . 5 5 5 5 . . . . . . . 5 . . . W 
W . 5 5 . . . . 5 5 5 . . . . . . . . . . . . . . . . . . . . . . . . . . . . . . . . . . 5 . . . W 
W . 5 5 . . . . . 5 5 5 . . . . . . . . . . . . . . . . . . . . . . . . . . . . . . . . . 5 . . . W 
W . 5 5 . . . . . . 5 5 5 . . . . . . . . . . . . . . . . . . . . . . . . . . . . . . . . 5 . . . W 
W . 5 5 . . . . . . . 5 5 5 . . . . . . . . . . . . . . . . . . . . . . . . . . . . . . . 5 . . . W 
W . . 5 . . . . . . . . 5 5 . . . . . . . . . . . . . . . . . . . . . . . . . . . . . . . 5 . . . W 
W . . . 5 . . . . . . . . . . . . . . . . . . . . . . . . . . . . . . . . . . . . . . . . 5 . . . W 
W . . . . 5 . . . . . . . . . . . . . . . . . . . . . . . . . . . . . . . . . . . . . . . 5 . . . W 
W . . . . . 5 . . . . . . . . . . . . . . . . . . . . . . . . . . . . . . . . . . . . . . 5 . . . W 
W . . . . . . 5 . . . . . . . . . . . . . . . . . . . . . . . . . . . . . . . . . . . . . 5 . . . W 
W . . . . . . . 5 5 5 5 5 5 5 5 5 5 5 5 5 5 5 5 5 5 5 5 5 5 5 5 5 5 5 5 5 5 5 5 5 5 5 5 5 5 . . . W 
W . . . . . . . . . . . . . . . . . . . . . . . . . . . . . . . . . . . . . . . . . . . . . . . . W 
W . . . . . . . . . . . . . . . . . . . . . . . . . . . . . . . . . . . . . . . . . . . . . . . . W 
W . . . . . . . . . . . . . . . . . . . . . . . . . . . . . . . . . . . . . . . . . . . . . . . . W 
W . . . . . . . . . . . . . . . . . . . . . . . . . . . . . . . . . . . . . . . . . . . . . . . . W 
W . . . . . . . . . . . . . . . . . . . . . . . . . . . . . . . . . . . . . . . . . . . . . . . . W 
W . . . . . . . . . . . . . . . . . . . . . . . . . . . . . . . . . . . . . . . . . . . . . . . . W 
W . . . . . . . . . . . . . . . . . . . . . . . . . . . . . . . . . . . . . . . . . . . . . . . . W 
W . . . . . . . . . . . . . . . . . . . . . . . . . . . . . . . . . . . . . . . . . . . . . . . . W 
W . . . . . . . . . . . . . . . . . . . . . . . . . . . . . . . . . . . . . . . . . . . . . . . . W 
W . . . . . . . . . . . . . . . . . . . . . . . . . . . . . . . . . . . . . . . . . . . . . . . . W 
W . . . . . . . . . . . . . . . . . . . . . . . . . . . . . . . . . . . . . . . . . . . . . . . . W 
W . . . . . . . . . . . . . . . . . . . . . . . . . . . . . . . . . . . . . . . . . . . . . . . . W 
W . . . . . . . . . . . . . . . . . . . . . . . . . . . . . . . . . . . . . . . . . . . . . . . . W 
W W W W W W W W W W W W W W W W W W W W W W W W W W W W W W W W W W W W W W W W W W W W W W W W W W 